0000000000000000000011000000000000000111000000000000000100000000000000000000000000110000000000000000
0000000000000000001100000000000000000011000000000000000100000000000000000000000000001111111111111000
0000000000000000010000000000000000000001100000000000000100000000000000000000000000000001110000001000
0000000000000001100000000000000000000000110000000000000100000000000000000000000000000000000000000100
0000000000000010000000000000000000000000011000000000000100000000000000000000000000000000000000000010
0000000000001100000000000000000000000000000111000000000100000000000000000000000000000000000000000001
0000000000010000000000000000000000000000000000110000000100000000000000000000000000000000000000000001
0000000000100000000000000000000000000000000000001100000100000000000000000000000000000000000000000001
0000000001000000000000000000000000000000000000000011000100000000000000000000000000000000000000000000
0000000010000000000000000000000000000000000000000001100100000000000000000000000000000000000000000000
0000000100000000000000000000000000000000000000000000110100000000000000000000000000000000000000000000
0000000100000000000000000000000000000000000000000000011100000000000000000000000000000000000000000000
0000001000000000000000000000000000000000000000000000000100000000000000000000000000000000000000000000
0000010000000000000000000000000000000000000000000000000100000000000000000000000000000000000000000000
0000100000000000000000000000000000000000000000000000000100000000000000000000000000000000000000000000
0000100000000000000000000000000000000000000000000000000100000000000000000000000000000000000000000000
0001000000000000000000000000000000000000000000000000000100000000000000000000000000000000000000000000
0010000000000000000000000111111110000000000000000000000100000000000000000000000000000000000000000000
0010000000000000000000011000000001100000000000000000000100000000000000000000000000000000000000000000
0010000000000000000000100000000000010000000000000000000100000000000000000011111100000000000000000000
0100000000000000000001100000000000001000000000000000000100000000000000000100000010000000000000000000
0100000000000000000001000000000000001000000000000000000100000000000000001000000001000000000000000000
0100000000000000000010000000000000000100000000000000000100000000000000010000000001000000000000000000
1000000000000000000010000000000000000010000000000000000100000000000000110000000000100000000000000000
1000000000000000000010000000000000000010000000000000000100000000000001000000000000100000000000000000
1000000000000000000010000000000000000001000000000000000100000000000001000000000000100000000000000000
1000000000000000000010000000000000000001000000000000000100000000000001000000000000010000000000000000
1000000000000000000010000000000000000001000000000000000100000000000001000000000000010000000000000000
1000000000000000000010000000000000000000100000000000000100000000000001000000000000010000000000000000
1000000000000000000010000000000000000000100000000000000100000000000001000000000000010000000000000000
1000000000000000000010000000000000000000100000000000000010000000000001000000000000010000000000000000
0000000000000000000010000000000000000000100000000000000010000000000001000000000000001000000000000000
0000000000000000000010000000000000000000100000000000000010000000000000100000000000001000000000000000
0000000000000000000010000000000000000000100000000000000010000000000000110000000000001000000000000000
0000000000000000000010000000000000000000100000000000000010000000000000010000000000001000000000000000
0000000000000000000010000000000000000000100000000000000010000000000000010000000000001000000000000000
0000000000000000000010000000000000000000100000000000000010000000000000001000000000010000000000000000
0000000000000000000010000000000000000000100000000000000010000000000000001000000000010000000000000000
0000000000000000000010000000000000000000100000000000000010000000000000001000000000010000000000000000
0000000000000000000010000000000000000000100000000000000010000000000000001000000000100000000000000000
0000000000000000000010000000000000000000100000000000000010000000000000001000000001100000000000000000
0000000000000000000010000000000000000000100000000000000010000000000000001000000001000000000000000000
0000000000000000000010000000000000000001000000000000000010000000000000001000000001000000000000000000
0000000000000000000010000000000000000001000000000000000010000000000000001000000010000000000000000000
0000000000000000000010000000000000000001000000000000000010000000000000001000000010000000000000000000
0000000000000000000010000000000000000001000000000000000010000000000000001000000010000000000000000000
0000000000000000000010000000000000000001100000000000000010000000000000011000000100000000000000000000
0000000000000000000010000000000000000001000000000000000100000000000000010000000100000000000000000000
0000000000000000000010000000000000000010000000000000000100000000000000010000001000000000000000000000
0000000000000000000010000000000000000010000000000000000100000000000000011000001000000000000000000000
0000000000000000000010000000000000000100000000000000000100000000000000001000001000000000000000000000
0000000000000000000010000000000000000100000000000000001000000000000000001000001000000000000000000000
0000000000000000000001000000000000001100000000000000001000000000000000001000010000000000000000000000
0000000000000000000000100000000000001000000000000000001000000000000000001000010000000000000000000000
0000000000000000000000110000000000001000000000000000010000000000000000010000100000000000000000000000
0000000000000000000000010000000000001000000000000000010000000000000000010000100000000000000000000000
0000000000000000000000010000000000001000000000000000010000000000000000110001000000000000000000000000
0000000000000000000000010000000000001000000000000000010000000000000000100010000000000000000000000000
0000000000000000000000010000000000001000000000000000100000000000000000100010000000000000000000000000
0000000000000000000000010000000000001100000000000000100000000000000001000100000000000000000000000000
0000000000000000000000010000000000011000000000000000100000000000000010001100000000000000000000000001
0000000000000000000000010000000000100000000000000000100000000000000001001000000000000000000000000010
0000000000000000000000010000000000100000000000000001100000000000000001001000000000000000000000000010
0000000000000000000000010000000001000000000000000001000000000000000010010000000000000000000000000010
0000000000000000000000010000000010000000000000000011000000000000000010010000000000000000000000000100
0000000000000000000000010000000010000000000000000100000000000000000110100000000000000000000000001000
0000000000000000000000010000001100000000000000000100000000000000000100100000000000000000000000001000
0000000000000000000000100000001000000000000000000100000000000000000100100000000000000000000000010000
0000000000000000000000100000010000000000000000001000000000000000001000100000000000000000000000100000
0000000000000000000001000000010000000000000000001000000000000000011000100000000000000000000000100000
0000000000000000000001000000100000000000000000001000000000000000010000100000000000000000000000100000
0000000000000000000001000000100000000000000000010000000000000000010000100000000000000000000000100000
0000000000000000000010000000100000000000000000000000000000000000110000100000000000000000000000100000
0000000000000000000010000000100000000000000000000000000000000000100000100000000000000000000000010000
0000000000000000000010000000100000000000000000000000000000000001000000100000000000000000000000010000
0000000000000000000100000000100000000000000000000000000000000001000000100000000000000000000000001000
0000000000000000000100000000100000000000000000000000000000000010000000100000000000000000000000000100
0000000000000000000100000000100000000000000000000000000000000010000000100000000000000000000000000011
0000000000000000000100000000100000000000000000000000000000000100000000100000000000000000000000000000
0000000000000000000100000000100000000000000000000000000000001000000000100000000000000000000000000000
0000000000000000001000000000100000000000000000000000000000001000000000100000000000000000000000000000
0000000000000000001000000000100000000000000000000000000000001000000000100000000000000000000000000000
0000000000000000010000000000100000000000000000000000000000001000000000100000000000000000000000000000
0000000000000000100000000000100000000000000000000000000000010000000000100000000000000000000000000000
0000000000000000100000000000100000000000000000000000000000010000000000100000000000000000000000000000
0000000000000000100000000000100000000000000000000000000000010000000000100000000000000000000000000000
0000000000000000100000000000100000000000000000000000000000100000000000100000000000000000000000000000
0000000000000000100000000000010000000000000000000000000000100000000000100000000000000000000000000000
0000000000000000100000000000010000000000000000000000000001000000000000100000000000000000000000000000
0000000000000000100000000000001100000000000000000000000010000000000000010000000000000000000000000000
0000000000000000100000000000000110000000000000000000000010000000000000010000000000000000000000000000
0000000000000000100000000000000011000000000000000000000100000000000000010000000000000000000000000000
0000000000000000100000000000000000100000000000000000001000000000000000010000000000000000000000000000
0000000000000000100000000000000000011000000000000000010000000000000000001000000000000000000000000000
0000000000000000100000000000000000000100000000000000100000000000000000001100000000000000000000000000
0000000000000000100000000000000000000011000000000001100000000000000000000010000000000000000000000000
0000000000000000100000000000000000000001111001001111000000000000000000000011100111111111111111111111
0000000000000000100000000000000000000000000111111000000000000000000000000000011000000000000000000000
0000000000000000100000000000000000000000000000000000000000000000000000000000000000000000000000000000
0000000000000000100000000000000000000000000000000000000000000000000000000000000000000000000000000000