0000000000000001000000000000000000000000000001111111111111110000000000000000000000000000000000000000
0000000000000001000000000000000000000000000110000000000000000000000000000000000000000000000000000000
0000000000000001000000000000000000000000011000000000000000000000000000000000000000000000000000000000
0000000000000001000000000000000000000000100000000000000000000000000000000000000000000000000000000000
0000000000000001000000000000000000000001000000000000000000000000000000000000000000000000000000000000
0000000000000001000000000000000000000011000000000000000000000000000000000000000000000000000000000000
0000000000000001000000000000000000000110000000000000000000000000000000000000000000000000000000000000
0000000000000001000000000000000000000100000000000000000000000000000000000000000000000000000000000000
0000000000000001000000000000000000001000000000000000000000000000000000000000000000000000000000000000
0000000000000001000000000000000000001000000000000000000000000000000000000000111111111110000000000000
0000000000000001000000000000000000010000000000000000000000000000000000011111000000000011100000000000
0000000000000001000000000000000000100000000000000000000000000000000011100000000000000000010000000000
0000000000000001000000000000000000100000000000000000000000000000011100000000000000000000001000000000
0000000000000001000000000000000001000000000000000000000000000001100000000000000000000000000100000000
0000000000000001000000000000000001000000000000000000000000000011000000000000000000000000000100000000
0000000000000001000000000000000010000000000000000000000000001100000000000000000000000000000100000000
0000000000000001100000000000000100000000000000000000000000001000000000000000000000000000000100000000
0000000000000000100000000000001100000000000000000000000000110000000000000000000000000000000100000000
0000000000000000100000000000010000000000000000000000000011000000000000000000000000000000000100000000
0000000000000000111000000001100000000000000000000000000100000000000000000000000000000000001000000000
0000000000000000001111111111000000000000000000000000011000000000000000000000000000000000001000000000
0000000000000000000000000000000000000000000000000000010000000000000000000000000000000000010000000000
0000000000000000000000000000000000000000000000000000100000000000000000000000000000000001100000000000
0000000000000000000000000000000000000000000000000011000000000000000000000000000000001110000000000000
0000000000000000000000000000000000000000000000000100000000000000000000000000000011110000000000000000
0000000000000000000000000000000000000000000000000100000000000000000000000111111100000000000000000000
0000000000000000000000000000000000000000000000000100000000000000000011111000000000000000000000000000
0000000000000000000000000000000000000000000000011000000000000000111100000000000000000000000000000000
0000000000000000000000000000000000000000000000110000000000001111000000000000000000000000000000000000
0000000000000000000000000000000000000000000001100000000000110000000000000000000000000000000000000000
0000000000000000000000000000000000000000000011000000000111000000000000000000000000000000000000000000
0000000000000000000000000000000000000000000010000000011000000000000000000000000000000000000000000000
0000000000000000000000000000000000000000000110000001100000000000000000000000000000000000000000000001
0000000000000000000000000000000000000000001100000110000000000000000000000000000000000000000000111111
1000000000000000000000000000000000000000001000000100000000000000000000000000000000000000000000100000
1000000000000000000000000000000000000000011000001100000000000000000000000000000000000000000011000000
1000000000000000000000000000000000000000110000001000000000000000000000000000000000000000011110000000
1000000000000000000000000000000000000000100000001000000000000000000000000000000000001111100000000000
1000000000000000000000000000000000000001100000001000000000000000000000000000000111110000000000000000
0100000000000000000000000000000000000001000000000100000000000000000000000000001000000000000000000000
0100000000000000000000000000000000000001000000000110000000000000000000000000110000000000000000000000
0010000000000000000000000000000000000001000000000011000000000000000000000001000000000000000000000000
0001100000000000000000000000000000000001000000000001000000000000000000000010000000000000000000000000
0000011000000000000000000000000000000010000000000000100000000000000000000100000000000000000000000000
0000000111000000000000000000000000000100000000000000110000000000000000001000000000000000000000000000
0000000000111000000000000000000000000100000000000000010000000000000000001000000000000000000000000000
0000000000000111110000000000000000001000000000000000001100000000000000011000000000000000000000000000
0000000000000000001111111100000111110000000000000000000100000000000000010000000000000000000000000000
0000000000000000000000000011111100000000000000000000000100000000000000010000000000000000000000000000
0000000000000000000000000000000000000000000000000000000100000000000000010000000000000000000000000000
0000000000000000000000000000000000000000000000000000000010000000000000011000000000000000000000000000
0000000000000000000000000000000000000000000000000000000010000000000000001000000000000000000000000000
0000000000000000000000000000000000000000000000000000000010000000000000001000000000000000000000000000
0000000000000000000000000000000000000000000000000000000010000000000000000100000000000000000000000000
0000000000000000000000000111111110000000000000000000000010000000000000000011110000000000000000000000
0000000000000000000011111000000011000000000000000000000001000000000000000000010000000000000000000000
0000000000000000011100000000000001100000000000000000000001100000000000000000011000000000000000000000
0000000000000001100000000000000000100000000000000000000000110000000000000000000100000000000000000000
0000000000000110000000000000000000010000000000000000000000011000000000000000000010000000000000000000
0000000000011000000000000000000000010000000000000000000000001000000000000000000001100000000000000000
0000000000100000000000000000000000010000000000000000000000000110000000000000000000110000000000000000
0000000011000000000000000000000000001000000000000000000000000010000000000000000000010000000000000000
0000000100000000000000000000000000001000000000000000000000000001000000000000000000001000000000000000
0000001000000000000000000000000000001000000000000000000000000000100000000000000000000100000000000000
0000110000000000000000000000000000001000000000000000000000000000110000000000000000000100000000000000
0001000000000000000000000000000000001000000000000000000000111111111000000000000000000010000000000000
0110000000000000000000000000000000001000000000000000001111000000011100000000000000000001000000000000
1000000000000000000000000000000000000100000000000001110000000000000100000000000000000000110000000000
0000000000000000000000000000000000000100000000000110000000000000000000000000000000000000010000000000
0000000000000000000000000000000000000100000000001100000000000000000000000000000000000000011000000000
0000000000000000000000000000000000000100000000001000000000000000000000000000000000000000001100000000
0000000000000000000000000000000000000100000000110000000000000000000000000000000000000000000010000000
0000000000000000000000000000000000000100000000100000000000000000000000000000000000000000000011000000
0000000000000000000000000000000000000010000001000000000000000000000000000000000000000000000001000000
0000000000000000000000000000000000000010000001000000000000000000000000000000000000000000000001000000
0000000000000000000000000000000000000010000010000000000000000000000000000000000000000000000000100000
0000000000000000000000000000000000000001000110000000000000000000000000000000000000000000000000100000
0000000000000000000000000000000000000001101100000000000000000000000000000000000000000000000000010000
0000000000000000000000000000000000000000011000000000000000000000000000000000000000000000000000010000
0000000000000000000000000000000000000000011000000000000000000000000000000000000000000000000000001000
0000000000000000000000000000000000000000000000000000000000000000000000000000000000000000000000001100
0000000000000000000000000000000000000000000000000000000000000000000000000000000000000000000000000100
0000000000000000000000001111111110000000000000000000000000000000000000000000000000000000000000000100
0000000000000000000000001000000001000000000000000000000000000000000001111111000000000000000000000100
0000000000000000000000010000000000100000000000000000000000000000000110000001100000000000000000000100
0000000000000000000000010000000000110000000000000000000000000000001000000000100000000000000000000100
0000000000000000000000100000000000010000000000000000000000000000010000000000010000000000000000000100
0000000000000000000000100000000000010000000000000000000000000000100000000000011000000000000000000100
0000000000000000000000100000000000001000000000000000000000000000100000000000001000000000000000001000
0000000000000000000000100000000000001000000000000000000000000001000000000000000100000000000000001000
0000000000000000000001000000000000001100000000000000000000000001000000000000000010000000000000010000
0000000000000000000001000000000000000100000000000000000000000010000000000000000010000000000000110000
0000000000000000000001000000000000000100000000000000000000000100000000000000000001100000000001000000
0000000000000000000001000000000000000010000000000000000000000100000000000000000000011000000011000000
0000000000000000000001000000000000000011000000000000000000111000000000000000000000000111111100000000
0000000000000000000001000000000000000001111000000000000001000000000000000000000000000000000000000000
0000000000000000000001000000000000000000000111110000001110000000000000000000000000000000000000000000
0000000000000000000001000000000000000000000000001111110000000000000000000000000000000000000000000000
0000000000000000000001000000000000000000000000000000000000000000000000000000000000000000000000000000
0000000000000000000001000000000000000000000000000000000000000000000000000000000000000000000000000000
