0000000000000000011000000000000000000000000000000000000000000000000000000000000000000000000000000000
0000000000000000001110000000000000000000000000000000000000010000000000000000000000000000000000000000
0000000000000000000011000000000000000000000000000000000001111100000000000000000000000000000000000000
0000000000000000000001111111000000000000000000000000000001000111111000000000000000000000000000000000
0000000000000000000000000001111000000000000000000000000010001000000111110000000000000000000000000000
0000000000000000000000000000001100000000000000000000000110010000000000001100000000000000000000000000
0000000000000000000000000000000100000000000000000000000100100000000000000110000000000000000000000000
0000000000000000000000000000000110000000000000000000001001000000000000000011000000000000000000000000
0000000000000000000000000000000010000000000000000000011010000000000000000000100000000000000000000000
0000000000000000000000000000000001000000000000000000011100000000000000000000100000000000000000000000
0000000000000000000000000000000000100000000000000000010000000000000000000000100000000000000000000000
0000000000000000000000000000000000110000000000000000010000000000000000000000010000000000000000000000
0000000000000000000000000000000000011000000000000000010000000000000000000000010000000000000000000000
0000000000000000000000000000000000001111111000000000010000000000000000000000001000000000000000000000
0000000001100000000000000000000000000000000111100000110000000000000000000000001000000000000000000000
0111111111011100000000000000000000000000000000010000100000000000000000000000000100000000000000000000
1000000000000010000000000000000000000000000000001100100000000000000000000000000100000000000000000000
0000000000000001100000000000000000000000000000000110100000000000000000000000000010000000000000000000
0000000000000000100000000000000000000000000000000010100000000000000000000000000010000000000000000000
0000000000000000110000000000000000000000000000000001100000000000000000000000000010000000000000000000
0000000000000000011000000000000000000000000000000001100000000000000000000000000010000000000000000000
0000000000000000001000000000000000000000000000000000100000000000000000000000000011000000000000000000
0000000000000000001000000000000000000000000000000000100000000000000000000000000001100000000000000000
0000000000000000001000000000000000000000000000000000100000000000000000000000000000110000000000000000
0000000000000000001000000000000000000000000000000000000000000001111100000000000000010000000000000000
0000000000000000001000000000000000000000000000000000000000000010000110000000000000011000000000000000
0000000000000000001100000000011100000000000000000000000000000110000010000000000000000110000000000000
0000000000000000000111111111110010000000000000000000000000000100000001000000000000000011000000000000
0000000000000000000000000000000001100000000000000000000000000100000000100000000000000000100000000000
0000000000000000000000000000000000011100000000000000000000000100000000110000000000000000100000000000
0000000000000000000000000000000000000110000000000000000000000100000000011000000000000000010000000000
0000000000000000000000000000000000000001000000000000000000000100000000001000000000000000001000000000
0000000000000000000000000000000000000000100000000000000000000100000000001000000000000000001100000000
0000000000000000000000000000000000000000010000000000000000000010000000001000000000000000000100000000
0000000000000000000000000000000000000000011000000000000000000010000000000100000000000000000100000000
0000000000000000000000000000000000000000001000000000000000000010000000000100000000000000000010000000
0000000000000000000000000000000000000000001100000000000000000010000000000100000000000000000010000000
0000000000000000000000000000000000000000000100000000000000000010000000000100000000000000000010000000
0000000000000000000000000000000000000000000100000000000000000010000000000110000000000000000001000000
0000000000000000000000000000000000000000000010000000000000000010000000000010000000000000000001000000
0000000000000000000000000000000000000000000010000000000000000010000000000010000000000000000001000000
0000000000000000000000000000000000000000000011000000000000000010000000000010000000000000000001000000
0000000000000000000000000000000000000000000001000000000000000010000000000001000000000000000001000000
0000000000000000000000000000000000000000000001000000000000000010000000000001000000000000000000100000
0000000000000000000000000000000000000000000001000000000000000010000000000001000000000000000000100000
0000000000000000000000000111100000000000000000100000000000000010000000000001000000000000000000100000
0000000000000000000001111000011111100000000000010000000000000010000000000001000000000000000001000000
0000000000000000000011000000000000100000000000010000000000000100000000000001000000000000000001000000
0000000000000000011100000000000000010000000000010000000000000100000000000001000000000000000001000000
0000000000000000110000010000000000001000000000001000000000000100000000000001000000000000000001000000
0000000000000011000011101000000000000100000000000100000000001100000000000001000000000000000011000000
0000000000000110001100000100000000000100000000000011111111110000000000000001000000000000000010000000
0000000000000100010000000010000000000100000000000000000000000000000000000001000000000000000010000000
0000000000000101000000000001000000000010000000000000000000000000000000000001000000000000000010000000
0000000000000101000000000000100000000010000000000000000000000000000000000011000000000000000010000000
0000000000001001000000000000010000000010000000000000000000000000000000000010000000000000000010000000
0000000000010100000000000000001000000010000000000000000000000000000000000011000000000000000010000000
0000000000011000000000000000000100000010000000000000000000000000000000000110000000000000000100000000
0000000000010000000000000000000010000010000000000000000000000000000000000110000000000000000100000000
0000000000010000000000000000000011000001000000000000000000000000000000011100000000000000001100000000
0000000000010000000000000000000000100001000000000000000000000000000000110000000000000000010000000000
0000000000100000000000000000000000010001000000000000000000000000000000100000000000000000100000000000
0000000000100000000000000000000000001001000000000000000000000000000111000000000000000011000000000000
0000000000100000000000000000000000001001000000000000000000000000001100000000000000000100000000000000
0000000000100000000000000000000000000101000000000000000000000000010000000000000000001000000000000000
0000000000100000000000000000000000000011000000000000000000000001100000000000000000011000000000000000
0000000001100000000000000000000000000010000000000000000000000011000000000000000000110000000000000000
0000000001000000000000000000000000000010000000000000000000000111000000000000000011100000000000000000
0000000001000000000000000000000000000010000000000000000000001001000000000000000111000000000000000000
0000000010000000000000000000000000000010000000000000000001110001000000000000001100000000000000000000
0000000010000000000000000000000000000010000000000000000010010001000000000000000111000000000000000000
0000000110000000000000000000000000000010000000000000000100010001000000000000000001111111000000000000
0000000100000000000001000000000000000100000000000000011000010001000000000000000000001000111000000000
0000001100000000000001000000000000000100000000000000100000010001000000000000000000000100000100000000
0000001000000000000001000000000000000100000000000000010000010001000000000000000000000010000010000000
0000001000000000000010000000000000000100000000000000011111110001000000000000000000000001100010000000
0000010000000000000010000000000000000100000000000000000000011111111100000000000000000000111001000000
0000110000000000000010000000000000000100000000000000000000000000000011110000000000000000100101100000
0000100000000000000010000000000000000100000000000000000000000000000000001000000000000000010010100000
0001100000000000000110000000000000000100000000000000000000000000000000000100000000000000010001100000
0110000000000000000100000000000000001000000000000000000000000000000000000010000000000000001000100000
0000000000000000000100000000000000001000000000000001111111111111110000000011000000000000001000100000
0000000000000000000100000000000000011000000000111111000000000000010000000011000000000000001000100000
0000000000000000000100000000000000001100001111000000000000000000001100000110000000000000001001100000
0000000000000000000100000000000000000111111000000000000000000000000111111100000000000000001011000000
0000000000000000000100000000000000000000000000000000000000000000000000000000000000000000001110000000
0000000000000000000100000000000000000000000000000000000000000000000000000000000000000000000100000000
0000000000000000000100000000000000000000000000000000000000000000000000000000000000000000000100000000
0000000000000000000100000000000000000000000000000000000000000000000000000000000000000000001000000000
0000000000000000001100000000000000000000000000000000000000000000000000000000000000000000010000000000
0000000000000000001000000000000000000000000000000000000000000000000000000000000000000000010000000000
0000000000000000001000000000000000000000000000000000000000000000000000000000000000000000110000000000
0000000000000000001000000000000000000000000000000000000000000000000000000000000000000011100000000000
0000000000000000011000000000000000000000000000000000000000000000000000000000000000001110000000000000
0000000000000000010000000000000000000000000000000000000000000000000000000000000000010000000000000000
0000000000000000110000000000000000000000000000000000000000000000000000000000000000100000000000000000
0000000000000000100000000000000000000000000000000000000000000000000000000000000011000000000000000000
0000000000000000100000000000000000000000000000000000000000000000000000000000000110000000000000000000
0000000000000000100000000000000000000000000000000000000000000000000000000011111100000000000000000000
0000000000000000100000000000000000000000000000000000000000000001111111111100000000000000000000000000